#######
#######
#######
#######
#######
#######

#######
#.#.#.#
#.#...#
#.#####
#.#...#
#######

#######
#.#.#.#
#######
###.#.#
###.#.#
#######

#######
#...#.#
#####.#
#.#.#.#
#...###
#######

#######
#.##.##
#.##.##
#.##.##
#....##
#######

#######
##....#
##.##.#
##..#.#
#####.#
#######

#######
#######
#######
#######
#####.#
#######
