#################################################################
#...#.......#.....#.#.........#.#.........#.#.....#.#...#...#.#.#
###.#####.#.#.###.#.#####.#.###.###.#######.#.#####.###.#.#.#.#.#
#.....#...#...#.....#.....#.....#.............#.......#.#.#.....#
#####.#.#########.###########.#######.#.###.#.#####.#.#.#######.#
#...#.#.#.#.....#...#...#...#.#...#...#...#.#.#.#...#...#.......#
###.#.#.#.#.#.#########.#.###.#.#####.#####.#.#.#######.#######.#
#...........#.....#.#...#.........#.....#...#.#...#.#...#...#...#
######.####.#####.#.#.#####.###########.###.#.#.#.#.###.###.#####
#.........#...#...#...#.....#.......#.#.#...#...#.#.......#.....#
#.###.###.#.#.#####.###.###.#.#####.#.###.#####.###.#######.###.#
#...#.#.#...#.#...#.#.#...#.#.....#.#.......#.#.#.....#...#...#.#
#.#.###.#.#.###.###.#.###.#.###.#.#########.#.#####.###.#.#######
#.#.#.#...#.#.....#.#...#.#...#.#.....#.#.......#.....#.#.#...#.#
#.###.#.###.###.#.#.#.#######.###.#.###.#.#.###.#####.#.#####.###
#.....#...#...#.#.#.....#.#.#.#.#.#...#...#.#.#.........#.#.#.#.#
###.#.#.###.###.#.#.#####.#.#.#.#####.#######.#.###.#.###.#.#.#.#
#...#.....#.....#.......#.......#.....#...........#.#.#...#.#...#
#.#.#####.#######.#.#######.#########.###.#.#.###.###.#.#.#.#####
#.#.#.#...#.....#.#.....#.#.#.#.#.#.#.......#.#.....#.#.#...#...#
#.###.#.#######.#######.#.#.#.#.#.#.#.#####.###.###.#.#.#.#.###.#
#...............#.....#...#.#.#...#.#.#...#.....#...#...#.#.#...#
#######################.#########################################
